abstruse - difficult to understand; obscure
obfuscate - to deliberately make something unclear or difficult to understand
perspicacious - having keen mental perception and understanding
sesquipedalian - characterized by long words; long-winded
ephemeral - lasting for a very short time
sycophant - a person who acts obsequiously toward someone to gain advantage
recalcitrant - having an obstinately uncooperative attitude
obsequious - obedient or attentive to an excessive degree
fastidious - showing careful unhurried attention to detail
pernicious - having a harmful effect, especially in a gradual or subtle way
prevaricate - to speak or act in an evasive way
egregious - outstandingly bad; shocking
ubiquitous - present, appearing, or found everywhere
perfunctory - carried out with minimal effort
sagacious - having or showing keen mental discernment and good judgment
arcane - understood by few; mysterious or secret
inexorable - impossible to stop or prevent
pragmatic - dealing with things sensibly and realistically
arduous - involving or requiring strenuous effort; difficult and tiring
serendipity - the occurrence of events by chance in a happy or beneficial way
insidious - proceeding in a gradual, subtle way, but with harmful effects
paradigm - a typical example or pattern of something
enigmatic - difficult to interpret or understand; mysterious
taciturn - reserved or uncommunicative in speech; saying little
cacophony - a harsh, discordant mixture of sounds
equivocate - use ambiguous language to conceal the truth or avoid commitment
esoteric - intended for or likely to be understood by only a small number of people
idiosyncrasy - a distinctive or peculiar feature or characteristic
juxtaposition - the fact of two things being placed close together with contrasting effect
loquacious - tending to talk a great deal; garrulous
meticulous - showing great attention to detail; very careful and precise
nefarious - wicked or criminal
ostensible - stated or appearing to be true, but not necessarily so
platitude - a remark or statement that is unoriginal, esp. one uttered as if it were fresh or profound
quixotic - exceedingly idealistic; unrealistic and impractical
recondite - difficult to understand or obscure; abstruse
supercilious - behaving or looking as though one thinks one is superior to others
temerity - excessive confidence or boldness; audacity
ubiquitous - present, appearing, or found everywhere
vacillate - waver between different opinions or actions; be indecisive
wanton - deliberate and unprovoked; gratuitous
zenith - the time at which something is most powerful or successful
abeyance - a state of temporary disuse or suspension
byzantine - excessively complicated, typically involving a great deal of administrative detail
caustic - sarcastic in a scathing and bitter way
didactic - intended to teach, particularly in having moral instruction as an ulterior motive
efficacious - effective as a means, remedy, or action
feckless - lacking initiative or strength of character; irresponsible
garrulous - excessively talkative, especially on trivial matters
hapless - unfortunate; unlucky
inimical - tending to obstruct or harm
jettison - throw or drop from an aircraft or ship
languid - displaying or having a disinclination for physical exertion or effort
mellifluous - sweet or musical; pleasant to hear
noxious - harmful, poisonous, or very unpleasant
occlude - stop, close up, or obstruct
parsimonious - unwilling to spend money or resources
querulous - complaining in a petulant or whining manner
reticent - not revealing one's thoughts or feelings readily
sapient - wise, or attempting to appear wise
torpid - mentally or physically inactive; lethargic
unctuous - excessively or ingratiatingly flattering
verdant - green with grass or other rich vegetation
welter - a confused mass of things
xerophilous - adapted to a dry environment
yoke - a wooden crosspiece fastened over the necks of two animals and attached to a plow or cart
zeitgeist - the defining spirit or mood of a particular period of history 